111111111111111111
100000100010000001
100000101010100001
100000101010100001
100000101010100001
1E0C0P000000100001
111111111111111111