111111111111111111
100000100010000001
100000101010100001
100000101010100001
1000011110101000001
100001111010100001
1EC0000P1000100001
111111111111111111