11111111111111
10000010101001
10000010101001
1EC00P00100001
11111111111111