111111111111111111
100000100010000001
100000101010100001
100000101010100001
100001111010100001
100000000010100001
1ECPP0000000100001
111111111111111111